1111111111111111111111
11100011100000000000C1
11100P00000000C0000111
111111110C001111110001
100000000000CE10010001
1000001111111110010001
1000001C11111000110001
100000000C001000100001
1000000000000000000001
1111111111111111111111